%%%%%%%%%%%%%%%%%%%%%%%%%%%%%%%%%%%%%
%         % %           %   %     % %
%  %%%%%%%% %%% % %%% %%% %%%%%%% % %
%       %       % %     %     % %   %
%%%%% %%%%% %%% % % % %%% %%%%% % %%%
%   % % % %   % % % %   % %   % %   %
% %%% % % % %%% %%%%% %%% % %%% %%% %
%       %     %   %   %     % % %   %
%%%%%  %%%%%% %%%%%%% %%% %%% % % % %
%             %   P   % %   %     % %
% % %%%%% % %%% % % %%% % %%% %%% % %
% % %     % % % % %     %   % % % % %
% % % %%%%%%% % %%%%%%%%% %%% % %%% %
% % % %   %  %   %     %         %  %
%%% %%%%% %%%%% %%%%% %%% %%% %%%%% %
%     % % %     % %     % %   % % % %
% % % % % %%% %%% %%% %%% % % % % % %
% % % % %                 % % %     %
%%% %%%%%%% % %%%%  %% %%%%%%%%% %%%%
%       % % % %     %   %     % %   %
%%%%% % % %%%%% %%% %%%%%%%%%%% % %%%
%   % % %         % %     %   % %   %
% %%% %%%%% %%%  %%%% %%%%% % % %%% %
% %   %      %        %     %       %
% % % %%% %%%%% % % % % %%%%%%%%%%%%%
% % %   %     % % % %       %   % % %
% % %%% %%% % % % %%%%%%%%% %%% % % %
% %   % %   % % %   % %   % % %     %
% %%% % % %%%%% %%% % % %%%%% % %%%%%
%       %   %     % %     %   % %   %
%%% % %%%%%% %%%%% %%% %%% % %%% % %%
% % % % % % % %     % %   % %   % % %
% % %%% % % % % %%%%%%%%% % % % % % %
%   %   %   %                 %     %
% % % % %%% %%% %%%%%%% %%%  %% %%  %
%.% % %       %   %       %   % %   %
%%%%%%%%%%%%%%%%%%%%%%%%%%%%%%%%%%%%%