%%%%%%%%%%%%%%%%%%%%%%%%%%%%%%%%%%%%%
%                       %   %     % %
%%%%%%%%%%% %%% % %%% %%% %%%%%%% % %
%       %       % %     %     % %   %
%%%%% %%%%% %%% % % % %%% %%%%% % %%%
%   % % % %   % % % %   % %   % %   %
% %%% % % % %%% %%%%% %%% % %%% %%% %
%       %     %   %   %     % % %   %
%%% %%%%%%%%% %%%%%%% %%% %%% % % % %
%             %       % %   %   P % %
% % % % % % %%% % % %%% % %%% %%% % %
% % % %%  % % % % %     %   % % % % %
% % % %%%%%%% % %%%%%%%%% %%% % %%% %
% % % %     %   %     %     %   %   %
% % %%% % %%%%% %%%%% %%% %%% %%%%% %
%     % % %     % %     % %   % % % %
% % % % % %%% %%% %%% %%% % % % % % %
% % % % %                 % % %     %
% % %%%%%%% % % %%%%% %%% % %%% %%%%%
%       % % % %     %   %     % %   %
% % % % % %%%%%%%%% %%%%%%%%%%% % %%%
%   % %           % %     %   % %   %
% % % %%%%% %%%%%%%%% %%%%% % % %%% %
% %   %      %        %     %       %
% % % %%%%% %%% % % % % %%%%%%%%%%%%%
% % %   %     % % % %       %   % % %
% % %%% %%% % % % %%%%%%%%% %%%     %
% %   % %   % % %   % %   % % %     %
% %   %%% %%%%% %%% % % %%%%% % %%%%%
%       %   %     % %     %   % %   %
%%% % %%%%% %%%%% %%% %%% % %%% % %%%
% % % % % % % %     % %   % %   % % %
% % %%% %   % % %%%%%%%%% % % %     %
%   %   %   %                 %     %
% % %   %%  %%% %%%%%%% %%% %%% %%  %
%.% % %       %   %       %   % %   %
%%%%%%%%%%%%%%%%%%%%%%%%%%%%%%%%%%%%%