%%%%%%%%%%%%%%%%%%%%%%%%%%%%%%%%%%%%%
%         %%%           %   %     % %
%%%%%%%%% % %%% % %%%%%%% %%%%%%% % %
%       %       % %     %     % %   %
%%%%% %%%%% %%% % % % %%% %%%%% % %%%
%   % % % %   % % % %   % %   % %   %
% %%% % % % %%% %%%%% %%% % %%% %%% %
%       %     %   %   %     % % %   %
%%%  %%%%%%%  %%%%%%% %%% %%% % % % %
%             %       % %   %    P% %
% % %%%%% % %%% % % %%% % %%% %%% % %
% % %     % % % % %     %   % % % % %
% % % %%%%%%% % %%%%%%%%% %%% % %%% %
% % % %     %   %     %     %   %   %
%%% %%% % %%%%% %%%%% %%% %%% %%%%% %
%     % % %     % %     % %   % % % %
% % % % % %%% %%% %%% %%% % % % % % %
% % % % %                 % % %     %
% % % % %%% % % %%%%% %%% % %%% %%%%%
%       % % % %     %   %     % %   %
%%%%% % % %%%   %%% %%%%%%%%%%% % %%%
%   % %           % %     %   % %   %
% %%% %%%%% %%   %%%% %%%%% % % %%% %
% %   %      %        %     %       %
% % % %%%%% %%% % % % % %%%%%%%%%%%%%
% % %   %     % % % %       %   % % %
% % %%% %%% % % % %%  %%%%% %%% % % %
% %   % %   % % %   % %   % % %     %
% %%% %%% %%%%% %%% % %  %%%% % %%%%%
%       %   %     % %     %   % %   %
%%% % %%%%% %%%%% %%% %%  % %%% % %%%
% % % % % % % %     % %   % %   % % %
% % %%% % % % % %%%%%%%%  % % % % % %
%   %   %   %                 %     %
% % % % %%% %%% %%%%%%%  %%%%%% %%%%%
%.% % %       %   %           %     %
%%%%%%%%%%%%%%%%%%%%%%%%%%%%%%%%%%%%%